
############################
#D.........................#
#..........................#
#.............TTTTT........#
#....TTTT..................#
#..........................#
#..........#####...........#
#..........................#
#.......GGGG...............#
#..........................#
############################
